身份证号 绑定 几个 任性付 账户	__label__任性付
实名认证	__label__任性付
阿里 蚂蚁 花呗 京东白条 不用 上报 征信	__label__任性付
合并 上报 征信	__label__任性付
实名认证	__label__任性付
最低 还款额	__label__任性付
账单	__label__任性付
账单 日 账单 日 几号	__label__任性付
任性付 上报 征信 信用 记录 影响	__label__任性付
任性付 上报 征信 是否 客户 同意	__label__任性付
任性付 上报 征信	__label__任性付
任性付 代扣 还款 扣款 顺序	__label__任性付
任性付 提前 结清	__label__任性付
任性付 借款 支持 银行 发行 借记卡	__label__任性付
任性付 借款 限额	__label__任性付
任性付 免息期 多长	__label__任性付
任性付 用于 购房 买车	__label__任性付
任性付 业务 并入 账单	__label__任性付
任性付 主动 还款	__label__任性付
任性付 还款	__label__任性付
任性付 实名认证 中 绑定 银行 发行 银行卡	__label__任性付
任性付 已出 账单 部分 还款 输入 任意 金额	__label__任性付
任性付 手续费 收取 标准	__label__任性付
任性付 提供 还款 服务	__label__任性付
任性付 是否 优惠 票券 搭配 使用	__label__任性付
任性付 是否 提前 还款	__label__任性付
任性付 最高 贷款额度	__label__任性付
任性付 优势	__label__任性付
任性付 分期 还款 方式	__label__任性付
任性付 申请 多长时间 知道	__label__任性付
任性付 申请 条件	__label__任性付
任性付 短信 还款 提示 发送	__label__任性付
任性付 购物 贷款 支持 商品	__label__任性付
任性付 起贷 额度	__label__任性付
任性付 还款 规则	__label__任性付
任性付 额度 是否 循环	__label__任性付
任性付 端 开通 南京 银行 电子 账户	__label__任性付
任性付 线上 购物 收费	__label__任性付
任性付 账单 中 分期 贷款 收费	__label__任性付
任性付 账单 中 分期 贷款 首期 收费	__label__任性付
任性付 账单 还款	__label__任性付
任性付 账单 最低 还款额 剩余 本金 收费	__label__任性付
任性付 账单 最低 还款额 计算	__label__任性付
任性付 购物 贷款 享受 分期 免息 是否 分期	__label__任性付
任性付 贷款 逾期 后果	__label__任性付
任性付 还款 限额	__label__任性付
任性付 逾期 影响 个人信用	__label__任性付
任性付 逾期 还款	__label__任性付
任性付 逾期 额度 无法 使用	__label__任性付
任性付 逾期 违约金 收取	__label__任性付
任性付 非 账单 贷款 业务 每月 几号 还款	__label__任性付
任性 多久 账	__label__任性付
任性 收费	__label__任性付
任性 免息期	__label__任性付
使用 任性付 分期 购物 发生 退货 资金 处理	__label__任性付
使用 任性付 影响 银行 放 贷款	__label__任性付
使用 任性付 借钱 钱	__label__任性付
使用 任性付 是否 需 明确 用途	__label__任性付
办理 自动 代扣 时间 扣款	__label__任性付
修改 账单 日	__label__任性付
合并 上报 包含 类型 贷款	__label__任性付
合并 上报 周期 多长	__label__任性付
合并 报送 后会 好处	__label__任性付
任性付 贷款 期间 换货 处理	__label__任性付
申请 任性付 额度	__label__任性付
使用 任性付	__label__任性付
修改 任性付 绑定 手机号码	__label__任性付
找回 任性付 端 支付 密码	__label__任性付
找回 任性付 端 登录 密码	__label__任性付
操作 随借	__label__任性付
查看 征信 报告	__label__任性付
进行 实名认证	__label__任性付
实名认证 时 银行 账户 预留 手机号 需要 注册 时 填写 手机号 保持一致	__label__任性付
实名认证 通过率 高 银行	__label__任性付
客户 使用 任性付 分期 购物 发生 退货 资金 处理	__label__任性付
客户 使用 任性付 购买 商品 易购 赠送 云钻 优惠券 客户 赠送 云钻 优惠券 购买 商品 商品 发生 退货 客户 退还 易购 赠送 云钻 优惠券 商品质量 问题 导致 退货 处理	__label__任性付
已经 上报 人行 多笔 贷款 记录 合并	__label__任性付
征信 上报 贷款 笔数 多会 征信 影响	__label__任性付
急 需要 账户 冻结	__label__任性付
苏宁易购 网上 购物 使用 任性付 付款	__label__任性付
苏宁 门店 购物 使用 任性付 付款	__label__任性付
想 购买 两件 商品 购物车 合并 使用 任性付 支付	__label__任性付
任性付 绑定 银行卡 可否 更换	__label__任性付
负债 贷款 情况 征信 报告 体现	__label__任性付
新 客户 任性付 申请 额度 需要 提供 资料	__label__任性付
是否 支持 差额 还款	__label__任性付
还款 账户 里 存入 足够 金额 我司 不予 扣款 扣	__label__任性付
申请 任性付 失败 原因	__label__任性付
申请 任性付 多久 重新 申请	__label__任性付
目前 任性付 哪些地方 使用	__label__任性付
自动扣款 失败	__label__任性付
账单 周期 多长	__label__任性付
账户 冻结	__label__任性付
购物 分期 任性 每月 等额 先费 后本 选择 期数	__label__任性付
部分 还款 还款 任意 金额	__label__任性付
随借 收取 费用	__label__任性付
随借 还款	__label__任性付
随借 支持 部分 还款	__label__任性付
人脸识别 失败	__label__任性贷
任性贷 额度 变成	__label__任性贷
时间 自动 代扣	__label__任性贷
代扣 失败 原因	__label__任性贷
任性贷 借款 失败	__label__任性贷
任性贷 产品 费率 计算	__label__任性贷
任性贷 借款 分期	__label__任性贷
任性贷 借款 显示 放款 中	__label__任性贷
任性贷 提额	__label__任性贷
任性贷 门店 使用	__label__任性贷
任性贷 还款	__label__任性贷
任性贷 开通 需要 多久	__label__任性贷
任性贷	__label__任性贷
任性贷 是否 支持 借款	__label__任性贷
任性贷 可用 额度 突然 变为 页面 显示 冻结	__label__任性贷
任性贷 还款 日 几号	__label__任性贷
任性贷 逾期 违约 产生 影响	__label__任性贷
使用 任性贷	__label__任性贷
申请 任性贷	__label__任性贷
征信 上报	__label__任性贷
扫码支付 时 任性贷 支付 选项	__label__任性贷
现金 分期 单笔 申请 最高 额度	__label__任性贷
申请	__label__任性贷
三 证 合一 填写	__label__企业易付宝
企业 易付宝 充值 账	__label__企业易付宝
企业 易付宝 功能	__label__企业易付宝
企业 易付宝 充值	__label__企业易付宝
企业 易付宝 登录	__label__企业易付宝
企业 易付宝 绑定 银行卡	__label__企业易付宝
企业 易付宝 提现 账	__label__企业易付宝
企业 易付宝 提现 失败	__label__企业易付宝
企业 汇款 账 时间	__label__企业易付宝
企业 汇款 操作	__label__企业易付宝
企业 汇款 退款 周期	__label__企业易付宝
企业 零钱宝 转入	__label__企业易付宝
企业 零钱宝 转 出	__label__企业易付宝
企业 零钱宝 收益	__label__企业易付宝
企业 零钱宝	__label__企业易付宝
咨询 企业 易付宝 实名认证 支持 银行	__label__企业易付宝
咨询 修改 企业 名称	__label__企业易付宝
咨询 修改 密码保护 问题	__label__企业易付宝
咨询 修改 法定代表 手机号	__label__企业易付宝
咨询 修改 账户 密保	__label__企业易付宝
咨询 修改 邮箱 账号	__label__企业易付宝
咨询 实名认证 原因	__label__企业易付宝
咨询 绑定 手机 新增 修改 绑定 手机	__label__企业易付宝
咨询 账户 类型 选择	__label__企业易付宝
外籍 企业法人 实名认证	__label__企业易付宝
解绑 银行卡	__label__企业易付宝
委托 提现 修改 规则	__label__企业易付宝
委托 提现 开通	__label__企业易付宝
委托 提现 时效	__label__企业易付宝
实名 打款 时间 咨询	__label__企业易付宝
实名认证 流程	__label__企业易付宝
批量 付款 账 时间	__label__企业易付宝
批量 付款 操作步骤	__label__企业易付宝
支付 密码 找回	__label__企业易付宝
激活	__label__企业易付宝
登陆密码 修改	__label__企业易付宝
营业执照 身份证 到期 已经 过期	__label__企业易付宝
账号 注册	__label__企业易付宝
信用卡 还款 限额	__label__信用卡还款
信用卡 还款 信息 填错 撤销	__label__信用卡还款
想 平台 信用卡 还款 提醒 关闭 关	__label__信用卡还款
易付宝 信用卡 还款	__label__信用卡还款
延保 发票 收到	__label__延保
延保 购买	__label__延保
延保 服务 保 问题	__label__延保
组合 支付	__label__支付
货到付款	__label__支付
银行卡 支付	__label__支付
支付宝 微信付	__label__支付
修改 支付 方式	__label__支付
使用 信用卡 分期	__label__支付
使用 包 支付	__label__支付
使用 苏宁 卡 支付	__label__支付
分期	__label__支付
快捷 支付	__label__支付
支付宝 支付	__label__支付
使用 信用卡 支付	__label__支付
使用 银联 支付	__label__支付
微信 支付	__label__支付
支付宝 支付 超 限额	__label__支付
网银 支付	__label__支付
苏宁 购物 支持 付款 方式	__label__支付
银行卡 限额	__label__支付
银行 手机号 使用 支付	__label__支付
门店 付款	__label__支付
修改 绑定 手机 多久 审核	__label__易付宝修改绑定手机号码
修改 绑定 手机 操作	__label__易付宝修改绑定手机号码
修改 绑定 手机 需要 资料	__label__易付宝修改绑定手机号码
修改 实名认证 信息	__label__易付宝实名认证
初级 认证 条件	__label__易付宝实名认证
初级 认证 流程	__label__易付宝实名认证
修改 激活 信息	__label__易付宝实名认证
清空 实名认证 信息	__label__易付宝实名认证
高级 认证 多长时间 审核	__label__易付宝实名认证
高级 认证 操作	__label__易付宝实名认证
高级 认证 需要 资料	__label__易付宝实名认证
关闭 小额 免密	__label__易付宝支付密码
关闭 指纹 支付	__label__易付宝支付密码
开启 小额 免密	__label__易付宝支付密码
开启 指纹 支付	__label__易付宝支付密码
支付 密码 找回	__label__易付宝支付密码
注销 账号	__label__易付宝注销
注销 账号 限制 条件	__label__易付宝注销
绑定 银行卡	__label__易付宝绑定/解绑银行卡
解绑 银行卡	__label__易付宝绑定/解绑银行卡
易付宝	__label__易付宝账户
提高 账号 类别	__label__易付宝账户
查询 账号 类别	__label__易付宝账户
手势 密码 设置	__label__易付宝账户
易付宝 余额 支付 限额	__label__易付宝账户
易付宝 充值 账	__label__易付宝账户
易付宝 充值 限额	__label__易付宝账户
易付宝 易购 绑定 流程	__label__易付宝账户
易付宝 易 购解 绑 流程	__label__易付宝账户
易付宝 充值	__label__易付宝账户
易付宝 提现	__label__易付宝账户
易付宝 提现 账	__label__易付宝账户
易付宝 提现 限额	__label__易付宝账户
易付宝 账号 挂失	__label__易付宝账户
易付宝 账号 解挂	__label__易付宝账户
易购 易付宝 换 绑 流程	__label__易付宝账户
登陆密码 修改	__label__易付宝账户
登陆密码 找回	__label__易付宝账户
苏宁金融 下载	__label__易付宝账户
解绑 换邦 限制 条件	__label__易付宝账户
账号 挂失	__label__易付宝账户
账号 注册	__label__易付宝账户
账号 登陆	__label__易付宝账户
账号 解冻	__label__易付宝账户解冻
账号 解冻 多久 审核	__label__易付宝账户解冻
易玺	__label__易玺
激活 易玺	__label__易玺
无法 检测 易玺	__label__易玺
易玺 购买	__label__易玺
易玺 激活 失败	__label__易玺
注销 易玺 咨询	__label__易玺
充值 流量 累计 下个月	__label__流量
充值 流量 账	__label__流量
手机 充值 获取 发票	__label__流量
流量 充值 成功 充值 失败	__label__流量
流量 充值 支付 成功 订单 显示 关闭	__label__流量
流量 充值 错误	__label__流量
变现 失败	__label__理财
产品 收益 计算	__label__理财
基金	__label__理财
变现 之前 收益 计算	__label__理财
变现 到期 应付 利息 计算	__label__理财
变现 多久 账	__label__理财
变现 失败	__label__理财
变现 成功 资金	__label__理财
变现 手续费	__label__理财
变现	__label__理财
变现 是否 次数 限制	__label__理财
变现 规则	__label__理财
变现 记录 查询	__label__理财
变现 金额 利率 设置	__label__理财
固收 理财	__label__理财
基金 确认	__label__理财
使用 理财券	__label__理财
取消 变现	__label__理财
操作 变现	__label__理财
理财	__label__理财
本期 可变 现金额 计算	__label__理财
理财 上线 时间	__label__理财
理财产品 是否 支持 提前 赎回	__label__理财
理财 到期	__label__理财
理财 账	__label__理财
理财 起息	__label__理财
理财 到期 资金	__label__理财
理财券 兑换	__label__理财
理财券 来源	__label__理财
理财 取消	__label__理财
理财 多久 变现	__label__理财
理财 购买	__label__理财
理财 是否 保本	__label__理财
理财 期限 多久	__label__理财
理财 区别	__label__理财
理财 还款 情况	__label__理财
理财 预约 成功	__label__理财
资金 冻结 零钱宝 期间 收益	__label__理财
购买 苏宁 卡	__label__礼品卡
查询 苏宁 卡 余额	__label__礼品卡
苏宁 卡 一次 几张	__label__礼品卡
苏宁 卡 转给 其他人	__label__礼品卡
苏宁 卡有 作用	__label__礼品卡
苏宁 卡 有效期 多久	__label__礼品卡
苏宁 卡 购买 商品 退款 退回	__label__礼品卡
苏宁 卡 过期	__label__礼品卡
请问 礼品 卡 发票 开 名目	__label__礼品卡
购买 苏宁 卡 发票	__label__礼品卡
充值 话费 账	__label__话费
充值 话费 充值 成功 充值 失败	__label__话费
充值 话费 号码 充值 错误	__label__话费
充值 话费 提示 请求 参数 合法 风控 校验 失败	__label__话费
手机 充值 获取 发票	__label__话费
话费 充值 支付 成功 订单 显示 关闭	__label__话费
账户 安全 险 保障 资金	__label__账户安全险
账户 安全 险 购买	__label__账户安全险
转账 失败	__label__转账
定期 转	__label__转账
通讯录 转账	__label__转账
转账 哪家 银行卡	__label__转账
编辑 删除 任务	__label__转账
定期 转 扣款	__label__转账
定期 转 是否 短信 提醒	__label__转账
定期 转 操作步骤	__label__转账
定期 转 限额	__label__转账
收款 方 信息	__label__转账
设置 定期 转 任务 账	__label__转账
转账 账	__label__转账
转账 使用 方式 支付	__label__转账
转账 失败 资金 退还	__label__转账
转账 操作	__label__转账
转账 限额	__label__转账
七日 年化 收益率	__label__零钱宝
万分 收益率	__label__零钱宝
零钱宝	__label__零钱宝
卡 转入 零钱宝	__label__零钱宝
原卡 注销 情况 转出	__label__零钱宝
更换 基金 收益 是否 损失	__label__零钱宝
转入 零钱宝 上限	__label__零钱宝
零钱宝 中 显示 收益 当天	__label__零钱宝
零钱宝 历史 收益 查看 路径	__label__零钱宝
零钱宝 安全性	__label__零钱宝
零钱宝 换 基金	__label__零钱宝
零钱宝 提现 费用	__label__零钱宝
零钱宝 收益 显示	__label__零钱宝
零钱宝 收益 单利 复利	__label__零钱宝
零钱宝 收益 计算公式	__label__零钱宝
零钱宝 明细 是否 支持 导出	__label__零钱宝
零钱宝 是否 保本	__label__零钱宝
零钱宝 直接 进入 网址	__label__零钱宝
零钱宝 支付 还款	__label__零钱宝
零钱宝 转入 方式	__label__零钱宝
零钱宝 转入 限额 要求	__label__零钱宝
零钱宝 转出 帐 时间	__label__零钱宝
零钱宝 转 出 原则	__label__零钱宝
零钱宝 转出 银行卡 易付宝 余额 限额	__label__零钱宝
零钱宝 钱 全额 转 出	__label__零钱宝
